1 1 1 1 1 1 1 1 1 1 1
1 2 2 2 7 2 2 2 2 2 1
1 2 0 0 0 0 0 0 0 2 1
1 2 0 0 0 0 0 0 0 2 1
1 2 0 0 0 0 0 0 0 2 1
1 2 2 2 2 2 2 2 2 2 1
1 4 4 4 4 4 4 4 4 4 1
1 4 0 0 0 0 0 0 0 4 1
1 4 0 0 0 0 0 0 0 4 1
1 4 0 0 0 0 0 0 0 4 1
1 4 0 0 0 0 0 0 0 4 1
1 4 4 4 4 4 6 4 4 4 1
1 1 1 1 1 1 1 1 1 1 1
